{
  "tiles0": {
    "-0,+0,-0": [
      "D"
    ]
  },
  "tiles1": {
    "-2,+0,-2": [
      "0000",
      "0000",
      "0000",
      "0000"
    ],
    "-1,+1,-1": [
      "D ",
      "  "
    ]
  },
  "tiles": {
    "-20,+0,-0": [
      "0"
    ],
    "-8,+0,-8": [
      "0000000000000000",
      "0000000000000000",
      "0011022003304400",
      "0011022003304400",
      "0000000000000000",
      "0000000000000000",
      "0000002222000000",
      "0000002EE2000000",
      "0000002EE2000000",
      "0000002222000000",
      "0000000000000000",
      "0000000000000000",
      "0055066007708800",
      "0055066007708800",
      "0000000000000000",
      "0000000000000000"
    ],
    "-8,+1,-8": [
      "9999999999999999",
      "9              9",
      "9              9",
      "9              9",
      "9              9",
      "9              9",
      "9              9",
      "9      C       9",
      "9  2           9",
      "9        2     9",
      "9       22     9",
      "9              9",
      "9              9",
      "9              9",
      "9              9",
      "9999999999999999"
    ],
    "-8,+2,-8": [
      "9999999999999999",
      "9              9",
      "9              9",
      "9              9",
      "9              9",
      "9              9",
      "9              9",
      "9              9",
      "9  D           9",
      "9              9",
      "9              9",
      "9              9",
      "9              9",
      "9              9",
      "9              9",
      "9999999999999999"
    ],
    "-8,+3,-8": [
      "                ",
      "                ",
      "                ",
      "                ",
      "                ",
      "                ",
      "A              A",
      "A              A",
      "A              A",
      "A              A",
      "                ",
      "                ",
      "                ",
      "                ",
      "                ",
      "                "
    ],
    "-8,+4,-8": [
      "                ",
      "                ",
      "                ",
      "                ",
      "                ",
      "                ",
      "                ",
      "A              A",
      "A              A",
      "                ",
      "                ",
      "                ",
      "                ",
      "                ",
      "                ",
      "                "
    ],
    "-8,+5,-8": [
      "                ",
      "                ",
      "  B          B  ",
      "                ",
      "                ",
      "                ",
      "                ",
      "AAAAAAAAAAAAAAAA",
      "AAAAAAAAAAAAAAAA",
      "                ",
      "                ",
      "                ",
      "                ",
      "  B          B  ",
      "                ",
      "                "
    ]
  },
  "entities": {
    "0": {
      "x": 0,
      "y": 0,
      "z": 0
    }
  }
}
